29 21
11101111111111101110111111111
10101000000010000010000000100
10111011111010111010101111101
00000000101010100010101010101
11111111101111111111101010111
10001010100000100000000010101
11101010111110111010101010101
00100000000010101010101010001
11101011111110101110101110101
00001000100000101000100010100
11111111111110101111101010111
00100010000000001000101010001
11101011101010111011101111111
10001010101010001010100000101
11101110101011101010111011101
10001000001010001000000010000
10101011111110111110111011101
00101000000010001000101010001
11101011111011111111101011111
10101000100010000000001000101
10111110111110111111111111101