33 19
111111111111111110111110101110101
100010000000101000000010100010101
101110101111101111101110111111111
100010101010001000100010000010000
111010101011101110101011111111111
001000100010001000001010100010001
101011101111101010101110111010111
101000100000001010100000001010100
111110111110111011101111101010101
100000000010001000101000001010101
101011111011111110111111101010111
101010000000000010000000100000100
101111101111101010111011111110111
100010001000001010001010000010100
111011111110111110111011101110111
101010000000001000100000001010100
101111111110111010111111101011111
101010100000001010100010001010001
101010111111101111111011111010111