13 9
1111101110111
0010001000001
1011111111111
1000000010100
1111111110101
0010000010001
1111101010111
1010001000100
1011111111111